..........
.S........
..........
..........
...#######
...#......
...#......
...#.#.E..
.....#....
.....#....