....................
.......----.........
.......-----........
.......-------......
.S...OOOOOO----.....
.......OOOOOOO...E..
......--OOOOOOO.....
..###...-----.......
..###......---......
..###...............